{
    "entities": [
        {
            "type": "az-head",
            "name": "Head",
            "x": 48, "y": 144
        },
        {
            "type": "az-altar",
            "name": "Altar",
            "x": 48, "y": 112
        },
        {
            "type": "az-altar",
            "name": "Altar2",
            "x": 80, "y": 112
        }
    ],
    "map": [
        [ 4,14,14,14,14,14,14,14,14,14,14,14,14,14,14,14,14, 5],
        [ 9,18, 6, 6, 6, 6, 6, 6, 6, 6, 6, 6, 6, 6, 6, 6,30, 7],
        [ 9,24,12,12,12,12,12,12,12,12,12,12,12,12,12,12,36, 7],
        [ 9,37,38,38,38,38,38,38,38,38,38,38,38,38,38,38,39, 7],
        [ 9,43,44,44,44,44,44,44,44,44,44,44,44,44,44,44,45, 7],
        [ 9,43,44,44,44,44,44,44,44,44,44,44,44,44,44,44,45, 7],
        [ 9,43,44,44,44,44,44,44,44,44,44,44,44,44,44,44,45, 7],
        [ 9,43,44,44,44,44,44,44,44,44,44,44,44,44,44,44,45, 7],
        [ 9,43,44,44,44,44,19,20,20,20,20,21,44,44,44,44,45, 7],
        [ 9,43,44,44,44,44,25,26,26,26,26,27,44,44,44,44,45, 7],
        [ 9,43,44,44,44,44,25,26,26,26,26,27,44,44,44,44,45, 7],
        [ 9,43,44,44,44,44,25,26,26,26,26,27,44,44,44,44,45, 7],
        [ 9,43,44,44,44,44,25,26,26,26,26,27,44,44,44,44,45, 7],
        [ 9,43,44,44,44,44,31,32,32,32,32,33,44,44,44,44,45, 7],
        [ 9,43,44,44,44,44,44,44,44,44,44,44,44,44,44,44,45, 7],
        [ 9,43,44,44,44,44,44,44,44,44,44,44,44,44,44,44,45, 7],
        [ 9,43,44,44,44,44,44,44,44,44,44,44,44,44,44,44,45, 7],
        [ 9,43,44,44,44,44,44,44,44,44,44,44,44,44,44,44,45, 7],
        [ 9,49,50,50,50,50,50,50,50,50,50,50,50,50,50,50,51, 7],
        [10, 2, 2, 2, 2, 2, 2, 2, 2, 2, 2, 2, 2, 2, 2, 2, 2,11]
    ],
    "tileset": "Yucatec",
    "collision": [
        {"x": 0,   "y": 0,   "w": 576, "h": 96,  "centered": false},
        {"x": 0,   "y": 32,  "w": 32,  "h": 576, "centered": false},
        {"x": 544, "y": 32,  "w": 32,  "h": 576, "centered": false},
        {"x": 0,   "y": 608, "w": 576, "h": 32,  "centered": false},
        {"x": 192, "y": 256, "w": 192, "h": 192, "centered": false}
    ]
}
