{
    "entities": [],
    "map": [
        [14,14,14,14,14,14,14,14,14],
        [ 6, 6, 6, 6, 6, 6, 6, 6, 6],
        [12,12,12,12,12,12,12,12,12],
        [38,38,38,38,38,38,38,38,38],
        [44,44,44,44,44,44,44,44,44],
        [44,44,44,44,44,44,44,44,44],
        [44,44,44,44,44,44,44,44,44],
        [50,50,50,50,50,50,50,50,50],
        [ 2, 2, 2, 2, 2, 2, 2, 2, 2]
    ],
    "left_wall": false, "right_wall": false,
    "tileset": "Aztec",
    "collision": [
        {"x": 0,   "y": 0,   "w": 288, "h": 96,  "centered": false},
        {"x": 0,   "y": 256, "w": 288, "h": 32,  "centered": false}
    ]
}
